clubbed is a 2008 british drama film about a 1980s factory worker who takes up a job as a club doorman, written by geoff thompson and directed by neil thompson.


== plot ==
in 1984, danny - a lonely factory worker intimidated by life - is battered and humiliated in front of his kids in a random act of violence. his already bleak existence sinks further into the abyss. on the verge of total breakdown, he decides to fight back.
he meets a group of nightclub doormen who take him in and give him the confidence to stand his ground. as he is drawn deeper into their world, he becomes embroiled with the local gangland boss, setting in motion a chain of events with shockingly brutal consequences.


== cast ==
colin salmon - louis
natalie gumede - jo
mel raido - danny
shaun parkes - rob
scot williams - sparky
maxine peake - angela
will poulter - sparky's baby son
neil morrissey - simon
ronnie fox - hennessy
charlie clark - illisa
katherine mcgolpin - kay
anthony ghosh - minor part at beginning
aicha mckenzie	- helen
nick holder - mick
ellen thomas - mrs. smith
ian ralph - barney aka fatman
tom mckay - skank
michelle marsh - skank's girlfriend
nikki sanderson - gee gee, dance teacher
jamie kenna - hack
ian virgo - leonard
ciarn griffiths - reaper
hayley evetts - reaper's girlfriend
angie chiefa - dancer
joanne rozak - dancer


== reception ==
empire gave the film three stars out of five stating "performances are varied, but it overcomes its low budget with a suspenseful story, sympathetic leads and cracking 80s soundtrack."


== references ==


== external links ==
clubbed at imdb