love khichdi is an indian hindi romantic comedy film, directed by srinivas bhashyam the film was released on 28 august 2009.


== plot ==
veer is a bachelor from a small town working as a sous-chef in a five-star hotel in mumbai, india. he is handsome, charming and easy-going and flirts with and lusts after any woman. with his ego, confusion and commitment issues, it is impossible for him to stop lying. the sometimes smart and sometimes silly observations of his all-male gang of coworkers at the hotel kitchen are of little help until veer is finally forced to grow up.


== cast ==
randeep hooda - veer pratap singh
sadha - sandhya iyengar
rituparna sengupta - sharmishta basu
divya dutta - parminder kaur
riya sen - deepti jignesh mehta
sonali kulkarni - shanti bheemrao bhansode
kalpana pandit - nafisa khan
jesse randhawa - susan raj
saurabh shukla - krishnan/guruji
sanjay mishra - tambe
mukesh bhatt - nandu
ujjwal chopra - vikas sharma
milind soman - subramani iyer


== crew ==
story and screenplay - srinivas bhashyam & manu joseph
dialogue - sandeep srivastava
additional dialogues - pankaj kapur
music - pritam
background score - srinivas bhashyam
director of photography - arjun jena
editor - sanjay sankla
art director - narendra rahurikar
choreography - al & mel
lyrics - amitabh varma, shaleen sharma
sound engineer - alok de, fiesta
d.i. and efx - prasad efx


== soundtrack ==


== references ==


== further reading ==
banerjee, malini (29 august 2009). "khichdi without comfort". the telegraph. archived from the original on 22 september 2020. cs1 maint: discouraged parameter (link)
tuteja, joginder (31 august 2009). "love khichdi". the new indian express. archived from the original on 22 september 2020. cs1 maint: discouraged parameter (link)
jhunjhunwal, udita (28 august 2009). "overcooked 'khichdi'". daily news and analysis. archived from the original on 22 september 2020. cs1 maint: discouraged parameter (link)
gupta, shubhra (28 august 2009). "love khichdi". the indian express. archived from the original on 22 september 2020. cs1 maint: discouraged parameter (link)


== external links ==
love khichdi at imdb